%%%%%%
%  P %
%    %
%.%  %
%%%%%%