%%%%%%%%
%P  H%.%
%J  H  %
%%%%%%%%